名偵探柯南|幻櫻|柯南事務所|豬豬|星光|極速|ByCanon|银光|风车|
魔術快鬥 (不定期)|異域|四魂|星塵|幻櫻|SOSG|猴團|
團地友夫|聽潺社|
未來之卡同伴之戰|小行|
劍靈|澄空|DHR|
蟲師續章|豌豆|極影|夢物語|华盟|異域|Dymy|動漫FANS|生徒會|A.I.R.nes|天香|幻之|漫盟之影|囧夏|聖域|諸神|星塵|青翼|SakuraCafe.FOSKY|搖籃|清藍|
JOJO-星塵鬥士|悠哈C9|諸神|A.I.R.nes.天香|楓雪連載|
FAIRY TAIL|豬豬|異域|Dymy|諸神|動漫國|天空树|楓雪連載|
Keroro軍曹|汐空|RH|異域|X2|
健全機鬥士|異域|DHR.輕之國度|
約會大作戰II|惡魔島|千夏|幻之|動漫國.DHR|NTR|萌物百科|澄空.華盟|TUcaptions|惡俗.KNA|银光|
櫻桃小丸子|丸子家族|银光|
海賊王(航海王)|楓雪連載|月光恋曲|豬豬|天空树|银光|
Lady 寶石寵物|愛戀.丸子|
鑽石王牌|幻櫻|極影|異域|Dymy|諸神|DA同音|
Happiness Charge光之美少女!|白戀|
金田一少年事件簿R|異域|極影|風車.汐空.丸子|琵琶行|諸神|
星刻的龍騎士|極影|KNA|輕之國度|BYSub|動漫國|生徒會|囧夏|恶俗|
魔法科高中的劣等生|KNA.DHR|動漫國|華盟.澄空|極影|Dymy|異域|諸神|
美妙旋律|風之聖殿|自由|
眾神的惡作劇|DA同音|風之聖殿|萌喵茶會|漫貓.愛戀|Dymy|青翼|
金色琴弦Blue♪Sky|異域|TUcaptions|諸神|漫貓.愛戀|
Captain Earth|白戀|Dymy|異域|風車.銀光|傲嬌零|A.I.R.nes.天香|DHR|
儘管如此世界依然美麗|異域|紫音|鈴風|自由|
相撲力士松太郎|異域|
七龍珠改魔人普烏篇|異域|幻櫻|天空樹|月光戀曲|
排球少年!!|極影|WOLF.白月|BY.Non-Limit|幻櫻|Dymy|聖域|幻之|異域|諸神|
目隱都市的演繹者|澄空華盟|漫盟|RH|動漫FANS|WOLF|動漫國|風車|囧夏|Dymy|極影|NTR|諸神|幻之|鈴風|
愚者信長|DHR.NTR.間人|惡魔島|流雲|
上課小動作|千夏|幻樱|極影|A.I.R.nesSub|樱律|異域|WOLF|Dymy|
網球優等生|白月|極影|
遊戲王ARC-V|HKACG|動漫國|
極黑的布倫希爾德|輕之國度|澄空|Dymy|動漫國|極影|異域|A.I.R.nes|夏砂|傲嬌零|
LoveLive!2nd|澄空.華盟|千夏|LoveEcho!|
破刃之劍|HKACG|動漫先鋒|
一週的朋友|動漫國|豌豆|澄空|極影|白月|WOLF|夢物語|幻之|千夏|TSDM|喵萌茶會|紫音|漫盟之影|異域|TUcaptions|汐空|DA同音|櫻律|青翼|諸神|Dymy|
如果折斷她的旗|輕之國度|澄空.華盟|
偶像傳說|風之聖殿|紫月|TC|
飙速宅男|小行|千夏|
漫畫家與助手|千夏|惡俗|幻櫻|TFO|極影|DHR|輕之國度|WOLF|異域|華盟|動漫國|TUcaptions|TSDM|
魔神之骨|異域|
M3 ~黑色鋼鐵~|極影|傲嬌零|
全職獵人|豬豬|動音漫影|DA|異域|幻櫻|WOLF|漫遊|TSDM|雪飄|流雲|楓雪連載|
魔法少女大戰|極影|惡俗|
漆黑的子彈|異域|動漫國|Dymy|櫻律|傲嬌零|夏砂|
史上最強弟子兼一黑暗襲擊||
噬魂师NOT!|Dymy|
火影忍者|旋風|極速|豬豬|月光戀曲|
妖怪手表|小行|Dymy|
監督不行屆|幻樱|
遊戲人生|千夏|白月|DHR.輕之國度|動漫國|極影|澄空|
棺姬嘉依卡|極影|WLGO|
風雲維新大將軍|惡魔島|
蠟筆小新|天空|琵琶行|银光|
Doraemon|天空|银光|
寵物小精靈|C2Club|嵐組@花園|動音漫影|ACB|月光戀曲|银光|夢幻戀櫻|
我們大家的河合莊|漫貓.愛戀|Dymy|極影|白戀|千夏|幻櫻|WLGO|
惡魔的謎語|幻之|極影|異域|櫻律|DHR|
選擇感染者WIXOSS|極影|千夏|
犬神同學和貓山同學|極影|幻之|千夏|WLGO|華盟|TSDM|傲嬌零|
愛絲卡&羅吉的鍊金工房|TUcaptions|幻之|極影|Dymy|囧夏|澄空.華盟|WOLF|DHR.NTR.間人|BBA.无限萌制|雪飘|
請問您要來點兔子嗎?|KNA|極影|千夏|動漫國|白月|Dymy|紫音|雪酷|丸子|萌物百科|澄空.華盟|DHR|RH|西農YUI|
乒乓|豌豆|A.I.R.nes|〇醬.小行|
龍孃七七七埋藏的寶藏|風車|極影|鈴風|動漫國|傲嬌零|愛戀|夏砂|DHR|紫音|
希德尼婭的騎士|極影|白戀|
